{
  "¢": "Â",
  "£": "Ê",
  "¤": "Ô",
  "µ": "à",
  "¸": "á",
  "©": "â",
  "·": "ã",
  "Ì": "è",
  "Ð": "é",
  "ª": "ê",
  "×": "ì",
  "Ý": "í",
  "ß": "ò",
  "ã": "ó",
  "«": "ô",
  "â": "õ",
  "ï": "ù",
  "ó": "ú",
  "ý": "ý",
  "¡": "Ă",
  "¨": "ă",
  "§": "Đ",
  "®": "đ",
  "Ü": "ĩ",
  "ò": "ũ",
  "¥": "Ơ",
  "¬": "ơ",
  "¦": "Ư",
  "­": "ư",
  "¹": "ạ",
  "¶": "ả",
  "Ê": "ấ",
  "Ç": "ầ",
  "È": "ẩ",
  "É": "ẫ",
  "Ë": "ậ",
  "¾": "ắ",
  "»": "ằ",
  "¼": "ẳ",
  "½": "ẵ",
  "Æ": "ặ",
  "Ñ": "ẹ",
  "Î": "ẻ",
  "Ï": "ẽ",
  "Õ": "ế",
  "Ò": "ề",
  "Ó": "ể",
  "Ô": "ễ",
  "Ö": "ệ",
  "Ø": "ỉ",
  "Þ": "ị",
  "ä": "ọ",
  "á": "ỏ",
  "è": "ố",
  "å": "ồ",
  "æ": "ổ",
  "ç": "ỗ",
  "é": "ộ",
  "í": "ớ",
  "ê": "ờ",
  "ë": "ở",
  "ì": "ỡ",
  "î": "ợ",
  "ô": "ụ",
  "ñ": "ủ",
  "ø": "ứ",
  "õ": "ừ",
  "ö": "ử",
  "÷": "ữ",
  "ù": "ự",
  "ú": "ỳ",
  "þ": "ỵ",
  "û": "ỷ",
  "ü": "ỹ"
}